-------------------------------------------------------------------------------------------------------------------------------------------------------------------------------------------------------------------------------
-------------------------------------------------------------------------------------------------------------------------------------------------------------------------------------------------------------------------------
-------------------------------------------------------------------------------------------------------------------------------------------------------------------------------------------------------------------------------
-------------------------------------------------------------------------------------------------------------------------------------------------------------------------------------------------------------------------------
-------------------------------------------------------------------------------------------------------------------------------------------------------------------------------------------------------------------------------
----------------------------------------------------------------------------------------------------------------------------------------------------------------------------------------------------------------y--------------
------------------Q--------------------------------------Q-Q-------------------------1-------------------------------------------------------QQQQ---------------------------------------------------------------##-------------
--------------------------------------------------------------------------------------------------oooo----------oooo------------oooo--------------------------------------------------------------------------y###-------------
--------------------------------------------------------------------------------------------------------------------------------------------------------------------------------------------------------------####-------------
-----------------------------------oo------------------------------------------------------------------------T---------------T-----------------y-------------------------------------------------------------#####-------------
---------------T--?---------------o--o-------------------Q-Q-----------------------QQQQ----------------------<>--------------<>-----------QQ?SSQQQ----------------------------------------------------------######---C---------
--------------<>--------------------------------------------------------------------------------#------------[]--------------[]-----------------------------T-------------------------#--------------------#######-------------
--------------[]--------------------------------------------------------------------------------#------------[]--------------[]-----------------------------<>------------------------#-------------------########--------F----
-M------------[]-------------------------------y-------------y----------------------yy----------#---------y--[]---y------y---[]-----------------------------[]------------------------#----y--y----------#########--------#----
XXXXXXXXXXXXXXXXXXXXXXXXX--XXXXXXXXXXXXXXXXXXXXXXXXXXXXXXXXXXXXXXXXXXXX----XXXXXXXXXXXXXXXXXXXXXXXXXXXXXXXXXXXXXXXXXXXXXXXXXXXXXXXXXXXXXXXXXXX--XXXXXXXXXXXXXXXXXXXXXXX---XXX--XXXXXXXX--XXXXXXXXXXXXXXXXXXXXXXXXXXXXXXXXXXXXXX
XXXXXXXXXXXXXXXXXXXXXXXXX--XXXXXXXXXXXXXXXXXXXXXXXXXXXXXXXXXXXXXXXXXXXX----XXXXXXXXXXXXXXXXXXXXXXXXXXXXXXXXXXXXXXXXXXXXXXXXXXXXXXXXXXXXXXXXXXX--XXXXXXXXXXXXXXXXXXXXXXX---XXX--XXXXXXXX--XXXXXXXXXXXXXXXXXXXXXXXXXXXXXXXXXXXXXX