----------------------------------------------------------------------------------------------------------------------------------------------------------------------------------------------------------------
----------------------------------------------------------------------------------------------------------------------------------------------------------------------------------------------------------------
----------------------------------------------------------------------------------------------------------------------------------------------------------------------------------------------------------------
----------------------------------------------------------------------------------------------------------------------------------------------------------------------------------------------------------------
----------------------------------------------------------------------------------------------------------------------------------------------------------------------------------------------------------------
------------------------------------------------------------------------------------------------------------------------------------------------------k---------------------------------------k-----------------
---------------------------------------------------------------------------------1-------USS------------------SSQSSS?SSS--------SSC------------------SQS--SQS--------------------------------##-----------------
--------------------------------------------------------------------------------------------------------------------------------------------------------------------------------------------###-----------------
-------------------------------------------------------------------------------------------------------------------------------------------g#---------------------------------#-----------k####-----------------
------------------Q--?---------------TT------------------------------------------ggg------------------TT--------K---------------SSS-------g##---------------------------k-----#-----------#####-----------------
---------------Q---------SSS---TT----<>-----------------TT--S--------------##########---#-------------<>------SSSSSSSSSSS-----------------###--------SQS--S?S--------SCSSS----#----------######-----------------
---------------------------K---<>----[]-----------------<>----------------##--------#---#-------------[]---------------------------------####--------------------------K-----##---------#######-----------------
-------------------------------[]----[]-----------------[]--------<>-----###--------#---##------------[]--------------------------------#####--------------------------------##--------########--------F--------
-------M----------------K------[]---g[]--------------ggg[]------k-[]----####--------#---##--gg----k---[]--------------K----------------######------k------ggg--------K---K---##-------#########--------#--------
XXXXXXXXXXXXXXXXXXXXXXXXXXXXXXXXXXXXXXXXXXXX---XXXXXXXXXXXXXXXXXXXXXXXXXXXXX--------X---XXXXXXXXXXXXXXXXXXXXXXXXXXXXXXXXXXXXXXX----XXXXXXXXXX--XXXXXXXXXXXXXXXXXXXXXXXXXXXXXXXX---XXXXXXXXXXXXXXXXXXXXXXXXXXXXXX
XXXXXXXXXXXXXXXXXXXXXXXXXXXXXXXXXXXXXXXXXXXX---XXXXXXXXXXXXXXXXXXXXXXXXXXXXX--------X---XXXXXXXXXXXXXXXXXXXXXXXXXXXXXXXXXXXXXXX----XXXXXXXXXX--XXXXXXXXXXXXXXXXXXXXXXXXXXXXXXXX---XXXXXXXXXXXXXXXXXXXXXXXXXXXXXX