-----------------------------------------------------------------------------------------------------------------------------------------------------------------------------------------------
-----------------------------------------------------------------------------------------------------------------------------------------------------------------------------------------------
-----------------------------------------------------------------------------------------------------------------------------------------------------------------------------------------------
-----------------------------------------------------------------------------------------------------------------------------------------------------------------------------------------------
-----------------------------------------------------------------------------------------------------------------------------------------------------------------------------------------------
-----------------------------------------------------------------------------------------------------------------------------------------------------------------------------------------------
-----------------------------US-----------------------------------------------------y------------------------------------------------------------------------------------###-------------------
----------------------------------------------------------------------------------#SSS---------------------------------------------------------y-------------------------###-------------------
---------------------------------------------------------------------oo----------##------------------------------------y---------------------#SS--o-------------------y--###-------------------
-----------------------------------------------------------------y--------------###1--------------ooo------------------XSS-?Q---------------##------------------------#--###-------------------
---------QQ-----------------####--SSC------------------ooo-------##-------------###-----------------------------------XX-------------------###--SC-------------------##--###-------------------
-----------------------y-#####----------------------------------###-----------#-###--SSS-------<>--------------------XXX------------------####---------------------y###--###-------------------
--------------------y-######-----------------------------------####----------##-###------------[]-------------------XXXX-------y---------#####---SSS---------------####--###--------F----------
-------------------#######------------------y-y---------------#####-------------###---------y--[]-------y--y-------XXXXX---SSSSS-----y--######--------------------#####--###--------#----------
XXXXXXXXXXXXX--XXXXXXXXX------XX--XXXXXXXXXXXXXXXX--XXXXXXXXXXXXXXX---XXXXXXXXXXXXXXXX---XXXXXXXXXXXXXXXXXXXXXXXXXXXXXXX-------XX-XXXXXXXXXXXX------XXXXXXXXX---XXXXXXX--XXXXXXXXXXXXXXXXXXXXXX
XXXXXXXXXXXXX--XXXXXXXXX------XX--XXXXXXXXXXXXXXXX--XXXXXXXXXXXXXXX---XXXXXXXXXXXXXXXX---XXXXXXXXXXXXXXXXXXXXXXXXXXXXXXX-------XX-XXXXXXXXXXXX------XXXXXXXXX---XXXXXXX--XXXXXXXXXXXXXXXXXXXXXX