----------------------------------------------------------------------------------------------------------------------------------------------------------------
----------------------------------------------------------------------------------------------------------------------------------------------------------------
----------------------------------------------------------------------------------------------------------------------------------------------------------------
-------------------------------------oo-------------------------------------------------------------------------------------------------------------------------
------------------------------------------g-g-------------------------------------------------------------------------------------------------------------------
---------------------------ooor---------%%%%%%%-------------oooo----------R------------------oo--oo-------------------------------------------------------------
--------------------------%%%%%----------|||||--------------%%%%----------------g----oo---------------------------R-----oo--------------------##----------------
---------------------------|||-----------|||||----oo---------||-------------%%%%%%------------------------r-----------------------------------##----------------
---------------------------|||-----------|||||---------------||--------------||||-----------------------%%%%%%%%-------------------SSS------####----------------
---------------------------|||-----%%%%%-|||||---------SSS---||--------------||||-----SS-----------------||||||-----------------------------####----------------
------------------------%%%%%%%%----|||--|||||---------------||-------%%%----||||-------------SS---------||||||-----%%%%--%%%%------------######----------------
-------------------------||||||-----|||--|||||-------------U-||--------|-----||||------------------------||||||------||----||-------------######----------------
-------------------------||||||--o--|||--|||||---------------||--------|-----||||-----------------%%%%---||||||------||----||-------------######--------F-------
------M-----------%%%%---||||||-%%%-|||--|||||---------------||--------|-----||||------------------||----||||||--ooo-||----||---------r---######--------#-------
XXXXXXXXXXXXXXXX---||----||||||--|--|||--|||||----%%%%-----%%%%%-%%%%%-|-----||||------------------||----||||||--%%%-||----||----XXXXXXXXXXXXXXXXXXXXXXXXXXXXXXX
XXXXXXXXXXXXXXXX---||----||||||--|--|||--|||||-----||-------|||---|||--|-----||||------------------||----||||||---|--||----||----XXXXXXXXXXXXXXXXXXXXXXXXXXXXXXX