----------------------------------------------------------------------------------------------------------------------------------------------------------------------------------------------------------------
----------------------------------------------------------------------------------------------------------------------------------------------------------------------------------------------------------------
----------------------------------------------------------------------------------------------------------------------------------------------------------------------------------------------------------------
----------------------------------------------------------------------------------------------------------------------------------------------------------------------------------------------------------------
-------------------------------------------------------------------------------------------------------------------------------------------------------------------------------------------XX-------------------
-------------------------------------------------------------------------------------------------------------------------------------------------------------------------------------------XX-------------------
-------------------------LSSS---------------------QQQQQ-----------USSS--------SSCSS------SSSS-----------------------------USSS-----------------------------------SSSSS---?-------------C---XX-------------------
-------------------------------------------------------------------------------------------------------------------------------------------------------------------------------------------XX-------------------
---------------------g---------------------------------------------------------------------------------------------------------TT----------------------------------------------------------XX-------------------
---------------------#---------------------TT-------k------------------TT---------------------------g-------------------E------<>----------------------------------------------------------XX-------------------
------------SUS-----##---2-----#-----------<>-----?QQQQ----------S-----<>---QQQQ--QQQ---------------<>-----------------<>------[]-----------------------------C--------Q-----TT-------SS---XX-------------------
-------------------###---------#-----------[]--------------------------[]---------------------------[]----------g------[]--<>--[]----------------------#---------------------<>------------XX-------------------
------------------####---------##----------[]--------------------------[]---------------------------[]----------<>-----[]--[]--[]------------------K---#---------------------[]------------XX--------F----------
------M----------#####----kk---##---gg-----[]------------gg----k-ggg---[]------------ggg------------[]----------[]--g--[]--[]--[]-----k----------------#-----gg-------K-K----[]--------k---XX--------X----------
XXXXXXXXXXXXXXXXXXXXXXXXXXXXXXXXXXXXXXXXXXXXXXXXXXXXXXXXXXXXXXXXXXXXXXXXXXXXXXXXXXXXXXXXX----XXXXXXXXXX---XXXXXXXXXXXXXXXXXXXXXXXXXXXXXX---XXXXXXXXXX--XXXXXXXXXXXXXXXXXXXXXXXXXXXXXXXXXXXXXXXXXXXXXXXXXXXXXXXXX
XXXXXXXXXXXXXXXXXXXXXXXXXXXXXXXXXXXXXXXXXXXXXXXXXXXXXXXXXXXXXXXXXXXXXXXXXXXXXXXXXXXXXXXXX----XXXXXXXXXX---XXXXXXXXXXXXXXXXXXXXXXXXXXXXXX---XXXXXXXXXX--XXXXXXXXXXXXXXXXXXXXXXXXXXXXXXXXXXXXXXXXXXXXXXXXXXXXXXXXX