----------------------------------------------------------------------------------------------------------------------------------------------------------------------------------------------------------------
----------------------------------------------------------------------------------------------------------------------------------------------------------------------------------------------------------------
----------------------------------------------------------------------------------------------------------------------------------------------------------------------------------------------------------------
----------------------------------------------------------------------------------------------------------------------------------------------------------------------------------------------------------------
----------------------------------------------------------------------------------------------------------------------------------------------------------------------------------------------------------------
----------------------------------------------------------------------------------g-----------------------------------------------------------------------------------------------------------------------------
----------------------!---------------------------------------------------------SSSSSSSS---SSS!--------------@-----------SSS----S!!S--------------------------------------------------------##------------------
-------------------------------------------------------------------------------------------------------------------------------------------------------------------------------------------###------------------
-------------------------------------------------------------------------------g----------------------------------------------------------------------------------------------------------####------------------
----------------------------------------------------------------1------------------------------------------------------------------------------------------------------------------------#####------------------
----------------!---S@S!S---------------------<>---------<>------------------S@S--------------C-----SU----!--!--!-----S----------SS------#--#----------##--#------------SS!S------------######------------------
--------------------------------------<>------[]---------[]-----------------------------------------------------------------------------##--##--------###--##--------------------------#######------------------
----------------------------<>--------[]------[]---------[]----------------------------------------------------------------------------###--###------####--###-----<>--------------<>-########--------F---------
---M-----------------g------[]--------[]-g----[]-----g-g-[]------------------------------------g-g--------k-----------------gg-g-g----####--####----#####--####----[]---------gg---[]#########--------#---------
XXXXXXXXXXXXXXXXXXXXXXXXXXXXXXXXXXXXXXXXXXXXXXXXXXXXXXXXXXXXXXXXXXXXX--XXXXXXXXXXXXXXX---XXXXXXXXXXXXXXXXXXXXXXXXXXXXXXXXXXXXXXXXXXXXXXXXXXXXXXXXXXXXXXXX--XXXXXXXXXXXXXXXXXXXXXXXXXXXXXXXXXXXXXXXXXXXXXXXXXXXXX
XXXXXXXXXXXXXXXXXXXXXXXXXXXXXXXXXXXXXXXXXXXXXXXXXXXXXXXXXXXXXXXXXXXXX--XXXXXXXXXXXXXXX---XXXXXXXXXXXXXXXXXXXXXXXXXXXXXXXXXXXXXXXXXXXXXXXXXXXXXXXXXXXXXXXX--XXXXXXXXXXXXXXXXXXXXXXXXXXXXXXXXXXXXXXXXXXXXXXXXXXXXX