------------------------------------------------------------------------------------------------------------------------------------------------------------------------------------------------
------------------------------------------------------------------------------------------------------------------------------------------------------------------------------------------------
------------------------------------------------------------------------------------------------------------------------------------------------------------------------------------------------
S-----SSSSSSSSSSSSSSSSSSSSSSSSSSSSSSSSSSSSSSSSSSSSSSSSSSS----------SSSSSSSSSSSSSSSSSSSSSSSSSSSSSSSSSSSSSSSSSSSSS-------SSSS-----SSSSSSSSSSSSSSSSSSSSSSSSSSS-----SSSSSSSSSSSSSSSSSSSSSSSSSSS-----
S-------------------SSSSSSSSSSSSSSSSSSSSSSSSSSSS----------------------------------------------------------------------------------------------------------------SSSSSSSSSSSSSSSS----------------
S-------------------SSSSSSSSSSSSSSSSSSSSSSSCSSSS----------------------------------------------------------------------------------------------------------------SSSSSSSSSSSSSSSS----------------
S-------------------SSSSSSSSSSSSSSSSSSSSSSSSSSSS--QQ------------CSS-----------T----------------------------------------SUS--------------------------------------SSSSSSSSSSSSSSSS----------------
S-----------------------------------------------------------------------------<>--------------------------------------------------------------------------------S-------------------<>----------
S----------------------------------------------------------SSS--2-------------[]-----------------------------------SSS------SSS---------------------------------S-------------------[]----------
S------------------------------------------ggg-----------------2-2------------[]-------S------------------------------------------------------T-------------------oooooooooo--------[]----------
S---------------------SSSSSS?-SSSSSSSSSSSSSSSSSS--QQ--QQQ---------2-----T---SC[]SU--T----------------------<>----------SSSS---------------T---<>-----------------USSSSSSSSSS----#---[]----F-----
S---------------------SSSSS---SSSSSSSSSSSSSSSSSS------------------------<>----[]----<>---<>-------------#--[]--##-------------------------<>--[]----------#--------------------##---[]---SS-----
S---------------------SSSSS---SSSSSSSSSSSSSSSSSS------------------------[]----[]----[]---[]------------##--[]--##------------------<>-----[]--[]---------##-SSS---------------###---[]---SS-----
S--------------------------oooSSSSSSSSSSSSSSSSSS------------------------[]---k[]---k[]--k[]---------kk-##--[]--##------------------[]----k[]--[]--------###-------------kk---####--k[]---SS-----
XXXXXXXXXXX--XX--X---XXXXXXXXXXXXXXXXXXXXXXXXXXXXXXXXXXXX------XXXXXXXXXXXXXXXXXXXXXXXXXXXXXXXXXXXXXXXXXX--XX--XX------XXXX------XXXXXXXXXXXXXXX--XXXXXXXXX-----XXXXXXXXXXXXXXXXXXXXXXX--XXXXXXX
XXXXXXXXXXX--XX--X---XXXXXXXXXXXXXXXXXXXXXXXXXXXXXXXXXXXX------XXXXXXXXXXXXXXXXXXXXXXXXXXXXXXXXXXXXXXXXXX--XX--XX------XXXX------XXXXXXXXXXXXXXX--XXXXXXXXX-----XXXXXXXXXXXXXXXXXXXXXXX--XXXXXXX