----------------------------------------------------------------------------------------------------------------------------------------------------------------------------------------------------------
----------------------------------------------------------------------------------------------------------------------------------------------------------------------------------------------------------
----------------------------------------------------------------------------------------------------------------------------------------------------------------------------------------------------------
----------------------------------------------------------------------------------------------------------------------------------------------------------------------------------------------------------
----------------------------------------------------------------------------------------------------------------------------------------------------------------------------------------------------------
----------------------------------------------------------------------------------g-----------------------------------------------------------------------------------------------------------------------
----------------------!---------------------------------------------------------SSSSSSSS---SSS!--------------@-----------SSS----S!!S--------------------------------------------------------##------------
-------------------------------------------------------------------------------------------------------------------------------------------------------------------------------------------###------------
-------------------------------------------------------------------------------g----------------------------------------------------------------------------------------------------------####------------
----------------------------------------------TT----------T-----1------------------------------------------------------------------------------------------------------------------------#####------------
----------------!---S@S!S-------------T-------<>---------<>------------------S@S--------------C-----SU----!--!--!-----S----------SS------#--#----------##--#------------SS!S------------######------------
--------------------------------------<>------[]---------[]-----------------------------------------------------------------------------##--##--------###--##--------------------------#######------------
----------------------------<>--------[]------[]---------[]----------------------------------------------------------------------------###--###------####--###-----<>--------------<>-########--------F---
---M-----------------g------[]--------[]-g----[]-----g-g-[]------------------------------------g-g--------k-----------------gg-g-g----####--####----#####--####----[]---------gg---[]#########--------#---
XXXXXXXXXXXXXXXXXXXXXXXXXXXXXXXXXXXXXXXXXXXXXXXXXXXXXXXXXXXXXXXXXXXXX--XXXXXXXXXXXXXXX---XXXXXXXXXXXXXXXXXXXXXXXXXXXXXXXXXXXXXXXXXXXXXXXXXXXXXXXXXXXXXXXX--XXXXXXXXXXXXXXXXXXXXXXXXXXXXXXXXXXXXXXXXXXXXXXX
XXXXXXXXXXXXXXXXXXXXXXXXXXXXXXXXXXXXXXXXXXXXXXXXXXXXXXXXXXXXXXXXXXXXX--XXXXXXXXXXXXXXX---XXXXXXXXXXXXXXXXXXXXXXXXXXXXXXXXXXXXXXXXXXXXXXXXXXXXXXXXXXXXXXXX--XXXXXXXXXXXXXXXXXXXXXXXXXXXXXXXXXXXXXXXXXXXXXXX